####################
#!A # ## !! ## # B!#
## # #  ####  # # ##
#        ##        #
##!              !##
#                  #
#    !   ##   !    #
#!      ####      !#
##      ####      ##
##      ####      ##
#!      ####      !#
#    !   ##   !    #
#                  #
##!              !##
#        ##        #
## # #  ####  # # ##
#!C # ## !! ## # D!#
####################
